Achaler : Contrarier quelqu'un
Acrimonie : mecontentement, amertume
Acrostiche : petit poeme dont les premieres lettres de chaque vers forment un nom, une devise...
Admonestation : réprimande
Affiquet : petit bijou que l'on fixe a une robe ou dans les cheveux
Agnelage : mise bas chez les brebis
Agoraphobie : crainte des espaces ouverts, des places publiques
Agueusie : perte du sens du gout
Alacrité : gaïté
Ambages : franchement. parler sans ambages équivaut à parler franchement
Amentifère : Qui porte des inflorescences en chatons !!!
Amok : crise de folie homicide dont sont parfois frappés certains opiomanes malais
Anachorète : Ascète qui vit seul
Anacoluthe : Rutpure dans la construction de la phrase
Anaphore : Repetition d'un mot ou d'un groupe de mot en debut de phrases successives
Androcéphale : qui a une tête humaine
Antonomase : emploi d'un nom commun ou d'une périphrase à la place d'un nom propre, ou inversement
Apagogie : Démonstration par l'absurde
Apophtegme : Maxime mémorable d'un illustre personnage
Aplacophore : classe de mollusques primitifs marins qui vivent dans la vase
Aporie : difficulté logique sans issue
arachibutyrophobie : Phobie d'avoir du beurre de cacahuète collé sur le palais
Atermoiement : action d'hésiter, de remettre à plus tard (s'utilise au pluriel)
Aubier : partie du tronc qui se situe sous l'ecorce. Ce sont les couches de l'arbre les plus récemment formées
Avers : face d'une pièce ou d'une médaille, opposée au revers
Avunculaire : Qui se rapporte à l'oncle ou à la tante
Babiller : bavarder beaucoup, inutilement
Balanoglosse : Ver des plages
Bamboche : faire la fête, guincher (vieux language familier). On dit 'faire bamboche'
Barbon : vieillard desagreable ou ennuyeux
Biaural : qui concerne l'audition par les 2 oreilles
Billevesée : propos frivole
Bimane : qui a deux mains (l'homme est un animal bimane)
Bome : espar horizontal sur lequel est enverguee une voile aurique, au tiers ou triangulaire
Bonzesse : religieuse bouddhiste
Boustrophedon : ecriture alternée de gauche à droite puis de droite à gauche
Cacochyme : D'une santé déficiente
Callipyge : Dont les fesses sont belles (une vénus callipyge)
Calter : s'enfuir rapidement
Campaniforme : qui à la forme d'une cloche
Capitation : Taxe par tête. Abolie en 1789 !
Cathartique : Qui purifie, qui permet de purger
Cénobite : qui vit en communauté
Cénotaphe : Tombeau élevé à la mémoire d'un mort mais qui ne contient pas son corps
Céphalalgie : Mal de tête
Châlit : Cadre de lit en bois ou en métal
Chattemite : Personne qui affecte des manières douces et modestes pour tromper son entourage
Charbonette : Bois d'un diamètre inférieur à 7 cm
Débagouler : Vomir
Décadique : Nombre ayant une infinité de chiffres avant la sortie, et une infinité de chiffres après la virgule Décalvant : Qui rend chauve
Décaniller : S'enfuir
Décitex : Poids d'un fil exprimé en gramme pour 10 000 mètres de fil
Dégoiser : Débiter des paroles
Délétère : Qui met la santé en danger
Déprédation : Vol et pillage suivi de dégradation
Déréliction : Etat de l'homme qui se sent abandonné, isolé, privé de tout secours divin
Dessiccateur : Appareil servant à déshydrater une substance ou à tenir divers produits à l'abri de l'humidité
Diaphane : Qui laisse passer les rayons lumineux sans permettre de distinguer les formes (translucide)
Diaphorèse : Transpiration abondante
Dispendieux : Qui exige une grande dépense
Distal : Qui est le plus éloigné d'un point de référence d'une structure
Diverticule : Cavité en forme de poche (en médecine, mais pas uniquement comme le diverticule axial de Lascaux)
Doxa : Ensemble des opinions communément admises dans une société donnée
Drolatique : Qui est récréatif et pytoresque
Ductile : Qui peut être étendu, allongé, sans se briser
Dynamogénie : Accroissement de la fonction d'un organe sous l'action d'une excitation
Ebaubi : Extrêmement étonné
Ebaudir : Egayer, réjouir
Eburné : Qui à la couleur et la consistance de l'ivoire
Echolalie : Répétition automatique des paroles de l'interlocuteur
Ecornifler : Se procurer çà et là aux dépens d'autrui
Egrotant : Souffrant
Electronarcose : Court sommeil provoqué par le passage d'un léger courant électrique à travers le cerveau
Emblavure : Terre ensemencée en céréale comme le blé
Emmouscailler : Emmerder
Empeigne : Dessus d'une chaussure, du cou-de-pied jusqu'à la pointe
Encoubler : Importuner, gêner
Enervation : Affaiblissement
Ensiforme : En forme d'épée
Entéléchie : Etat de perfection, de parfait accomplissement de l'être
Entropie : Mesure mathématique de la quantité d'incertitude et d'aléa
Entropion : Renversement des paupières en dedans
Epacte : Nombre qui exprime l'âge de la lune au 31 décembre de chaque année et qui indique combien il faut ajouter de jours à l'année lunaire pour qu'elle soit égale à l'année solaire
Epanadiplose : Qui termine comme cela a commencé (comme beaucoup de livres de Stephen King)
Epectase : Décès pendant l'orgasme
Epenthèse : Apparition à l'intérieur d'un mot d'un phonème non éthymologique
Epithalame : Poème composé à l'occasion d'un mariage, en l'honneur des jeunes mariés
Equanamité : Egalité d'âme, d'humeur
Ereuthophobie : Crainte, peur de rougir
Exonder : Sortir au-dessus de l?eau, en parlant d?une terre ou d'organismes aquatiques ou amphibies
Faix : Charge très pesante
Falarique : Arme de jet incendiaire
Faquin : Individu sans valeur, plat et impertinent
Fat : Qui montre sa prétention de façon déplaisante et quelque peu ridicule
Fatrasie : Poème du Moyen Age, d'un caractère incohérent ou absurde, formé de dictons, proverbes, etc... mis bout à bout et contenant des allusions satiriques
Fébricule : Petite fièvre
Fjeld : Plateau rocheux usé par un glacier continental
Fjord : Ancienne vallée glaciaire envahie par les eaux marines durant la déglaciation
Flagorner : Flatter bassement, servilement
Floculation : Rassemblement, sous forme de petits flocons, des particules d'une suspension colloïdale
Foirade : Le fait de foirer, de rater
Fondouk : Dans les pays arabes, emplacement du marché, ou auberge
Forclore : Exclure, se faire priver du bénéfice d'une faculté ou d'un droit non exercé dans les délais fixés
Formication : Fourmillement, agitation
Foucade : Caprice, emportement passager
Foutriquet : Personnage insignifiant et incapable
Fraichin : Odeur de marée
Frontispice : Façade principale d'un grand édifice
Fulguration : Lueur électrique qui se produit dans les hautes régions de l'atmosphère sans qu'on entende le tonnerre
Fustet : Sumac à houppes plumeuses, dont le bois fourni une matière tinctoriale jaune
Gabarre : Embarcation pour le transport de marchandise
Gadjo : Homme qui n'appartient pas à la communauté des Gitans
Galapiat : Polisson
Galéjade : Histoire inventée ou plaisanterie destinée à mystifier
Galimafrée : Plat peu appétissant
Galimatias : Discours confus et embrouillé
Gambit : Manoeuvre aux echecs consistant à sacrifier une pièce pour se donner un avantage
Garrocher : Lancer
Girie : Plainte affectée
Glabelle : Partie légérement proéminente située entre les 2 sourcils
Glairer : Frotter de blanc d'oeuf la couverture d'un livre pour lui donner du lustre
Glose : Annotation en marge d'un texte pour expliquer un mot difficile
Godailler : Faire des faux plis sur les vêtements
Gone : Jeune enfant
Gonochorisme : Séparation complète des sexes dans des individus distincts
Grandelet : Qui commence à devenir grand
Grigne : Fente du boulanger faite sur le pain
Halieutique : Qui concerne la pêche
Hapax : Mot, forme, emploi dont on ne peut relever qu'un exemple (à une époque donnée ou dans un corpus donné)
Haplologie : Fait de n'énoncer que l'une de deux articulations semblables et successives. (ex : tragicomique au lieu de tragico-comique)
Haret : Chat domestique retourné à l'état sauvage et vit du gibier
Hâve : Affaibli par la faim, la fatigue ou la souffrance
Hébertisme : Méthode d'éducation physique qui consiste en exercices effectués en plein air
Heimatlos : Qui a perdu sa nationalité d'origine sans en acquérir de nouvelle
Hellénisation : Fait de donner un caractère Grec à quelque chose (un pays, un peuple, un texte...)
Hendiadys : Figure de rhétorique qui consiste à dissocier en deux noms coordonnés une expression unique
Hercher : Pousser les wagonnets de minerai au fond d'une mine
Hétaïre : Prostituée d'un rang social élevé
Holisme : Théorie selon laquelle l'homme est un tout indivisible qui ne peut être expliqué par ses différentes composantes
Homoncule : Petit être vivant à forme humaine que les alchimistes prétendaient fabriquer
Hourvari : Cri des chasseurs pour rappeller les chiens perdus de vue. Synonyme de Tapage
Huis : Porte (d'où 'à huis clos')
Hypallage : Figure de style qui consiste à attribuer à certains mots d'une phrase ce qui convient à d'autres mots de la même phrase
Hyphe : Filament du mycélium des champignons supérieurs
Hypocondriaque : D'humeur triste et capricieuse
Hypotypose : Description animée et frappante
Ichtyoïde : Qui ressemble à un poisson
Impavide : Qui n'éprouve ou ne montre aucune peur
Impéritie : Manque d'aptitude, d'habileté notamment dans l'exercice de sa fonction
Implexe : Dont l'intrigue est compliquée
Inanité : Inutilité
Incipit : Premiers mots d'un manuscrit, d'un livre
Incube : Démon masculin censé abuser d'une femme pendant son sommeil
Incunable : Ouvrage imprimé avant 1500
Indigète : Propre à un lieu, à une famille
Ineffable : Qui ne peut-être exprimé par des paroles
Infixe : Elément qui s'insère dans l'intérieur d'un mot afin d'en modifier le sens
Infundibuliforme : Qui a la forme d'un entonnoir
Interdigital : Situé entre deux doigts
Intertidal : Zone d'oscillation de la marée
Irréfragable : Qu'on ne peut contredire
Jactance : Vanité
Jaculatoire : Prière courte et fervente
Jamborée : Réunion Internationale de scouts
Jangada : Radeau de bois très léger portant une cabane d'habitation utilisé par les pêcheurs brésiliens
Janotisme : Construction maladroite d'une phrase entrainant une mauvaise interprétation (ex : c'est la voiture de ma grand-mère qui est morte)
Jectisse : Qui peuvent se poser à la main
Jobastre : Imbécile un peu fou
Kaolin : Silicate d'alumine pur provenant de l'altération des feldspaths, des granits, argile qui compose les pâtes céramiques
Kaon : Particule élémentaire dont la masse est 970 fois plus grande que celle de l'électron
Kénophobie : Peur du noir
Kraken : Monstre marin fabuleux des légendes scandinaves
Labile ; Peu stable, qui tombe facilement
Lacunaire : Qui présente des lacunes
Lacustre : Qui vit près d'un lac
Laïusser : Discourir
Lallation : Emission de sons plus ou moins articulés par l'enfant, avant l'acquisition du langage
Latitudinaire : Qui a une morale très large, très relâchée
Latrie : Forme la plus élevée d'adoration qui ne doit être accordée qu'à Dieu seul
Laudatif : Qui contient un éloge
Lavure : Liquide qui a servi à laver quelque chose ou quelqu'un
Lège : Vide ou incomplétement chargé
Lénitif : Adoucissant, apaisant
Lépipodendron : Grand lycopode fossile arborescent de l'ère primaire
Lerche : Pas beaucoup, peu, bésef
Leucotomie : Lobotomie partielle
Levretté : Qui a la taille svelte, le ventre creusé du lévrier
Lexème : Morphème lexical libre
Lexis : Enoncé considéré indépendamment de sa vérité
Li : Mesure chinoise (environ 576 mètres)
Libelle : Court écrit de caractère satirique, pamphlet
Liminal : Qui est au niveau du seuil de perception (par opposition à subliminal)
Linéature : Nombre de ligne d'une image complète
Linge : Femelle du Lynx
Liponombre : Nombre qui lorsqu'il est écrit en toute lettre, ne contient pas de 'e'
Lipopremier : Liponombre qui est premier
Liteau : Lieu où le loup se repose pendant le jour
Lotier : Herbe des prés et des talus
Lucaniste : Amateur de cerfs-volants
Lucre : Profit plus ou moins licite dont on est avide
Lunisolaire : Qui a rapport à la fois à la Lune et au Soleil
Lutrin : Pupitre sur lequel on met les livres de chant
Macache : Pas du tout, rien du tout
Machure : Parties où le poil n'a pas été coupé net, a été écrasé
Mafflu : Qui a de grosse joue
Maganer : Fatiguer, affaiblir
Magyar : Qui a rapport au peuple établi au IXe siècle dans l'actuelle Hongrie
Maïeuticien : Homme qui exerce la profession de sage-femme
Makimono : Peinture japonaise sur soie ou papier, beaucoup plus large que haute
Maltose : Diholoside obtenu par action de l'amylase sur l'amidon
Maltôte : Impôt extraordinaire
Mamelouk : Cavalier des anciennes milices égyptiennes, garde du corps du sultan
Mandala : Représentation géométrique et symbolique de l'univers, dans le brahmanisme et le bouddhisme
Manducation : Acte de manger
Manuterge : Linge dont se sert le célébrant pour s'essuyer les mains au moment du lavabo pendant la messe
Maringouin : Insecte diptère tel que le moustique, le cousin
Maritorne : Femme laide, malpropre et désagréable
Mas : Maison de campagne ou ferme de Provence de style traditionnel
Matefaim : Galette, crêpe épaisse
Matras : Gros trait d'arbalète terminé par une tête cylindrique ou quadrangulaire
Maubèche : Bécasseau de grande taille du nord de l'Europe
Mazagran : Café chaud ou froid servi dans un verre
Mazdéisme : Religion zoroastrienne de l'Iran antique encore pratiquée par les Guèbres et les Parsis
Méandrine : Madrépore comprenant des polypiers vermiculés disposés en rangées sinueuses
Médianoche : Repas pris peu après minuit
Médicastre : Mauvais médecin, charlatan
Médiocratie : Gouvernement, domination des médiocres
Mennonite : Membre d'un mouvement anabaptiste dans la première moitié du XVIe siècle, aujourd'hui implanté aux pays-bas et aux Etats-Unis
Mentisme : Fuite des idées
Menuise : Petit plomb de chasse
Méphistophélique : Qui semble appartenir au démon Méphistophélès
Méphitique : Dont l'exhalaison est toxique et puante
Mérostomes : Classe d'arthropodes dont la bouche s'ouvre entre les pattes
Merzlota : Couche du sol et du sous-sol qui ne dégèle jamais
Meson : Hadron formé d'un quark et d'un antiquark
Métonymie : Figure de style qui consiste à utiliser un mot pour exprimer une idée ou un autre concept. Par exemple, "boire un verre" qui exprime boire le contenu
Mézigue : Synonyme de "Moi"
Micheton : Client d'un ou d'une prostitué
Mignoter : Traiter délicatement, avec gentillesse
Milliaire : Qui marque la distance d'un mille romain
Mimivirus : Virus géant à ADN de la taille d'une petite bactérie
Mirliflore : Jeune prétentieux
Misandre : Qui a de la haine ou du mépris pour les hommes (opposé de Misogyne)
Misantrhope : Personne qui manifeste de l'aversion pour ses semblables
Misogyne : Qui a de la haine et du mépris pour les femmes (opposé de Misandre)
Miston : Gamin, gamine
Mistoufle : Méchanceté, vilainie
Mithridatiser : Immuniser en accoutumant à un poison
Modénature : Profil des moulures en architecture
Moere : Lagune d'eau douce comblée, asséchée puis mise en culture
Monaural : Relatif à une seule oreille
Monergol : Produit apte à la propulsion d'un moteur de fusée
Monition : Avertissement donné par l'autorité ecclésiastique avant d'adresser une censure
Monoecie : Etat d'une plante monoïque
Monstration : Action de montrer
Monte-en-l'air : Voleur, cambrioleur
Mornifle : Baffe, gifle
Moujingue : Enfant plutôt difficile
Muance : Dans la solmisation, substitution d'un hexacorde à un autre
Musarder : Perdre son temps, flâner
Mutule : Ornement d'un entablement dorique qui est placé sous la larmier en face du triglyphe
Nadir : Point de la sphère céleste diamétralement opposé au zénith et qui se trouve sur la verticale de l'observateur
Naissain : Embryons ou larves des huitres et moules d'élevage
Nanan : Bonbons, friandises. C'est du Nanan signifie que c'est très facile
Nasarde : Pichenette sur le nez
Néoblaste : Cellule indifférenciée qui assure la reconstitution des parties accidentellement amputées chez certains animaux
Nervation : Disposition des nervures d'une feuille ou des ailes d'un insecte
Nervi : Tueur, homme de main
Nib : Synonyme de Rien
Nicodème : Nigaud
Nifé : Noyau de la Terre qui serait consitué de Nickel et de Fer
Nitescence : Lueur, rayonnement
Noctiluque : Qui peut émettre une lueur dans l'obscurité
Notule : Petite annotation à un texte
Nubile : Qui a atteint l'âge de se marrier
Objectivation : Rendre objectif
Objurgation : Reproche, réprimande
Obvie : Evident, logique
Oekoumène : Espace habitable de la surface terrestre
Onagre : Ane sauvage de grande taille
Onques : Jamais
Onguiculé : Qui a un ongle à chaque doigt
Onychophagie : Habitude de se ronger les ongles
Ophiolâtrie : Adoration du serpent
Opimes : Riches dépouilles ou riche profit
Opprobre : Qui humilie, qui déshonore
Oraliser : Lire ou réciter à haute voix un texte
Orant : Personnage représenté en prière, dans l'art chrétien ancien
Orbicole : Qui se trouve sur tous les points du globe
Orbitèle : Araignée qui tisse un toile polygonale à symétrie centrale
Oréade : Nymphe des montagnes et des bois
Organsiner : Tordre les fils de soie pour en obtenir l'organsin
Orillon : Partie d'un objet en forme de petite oreille
Oronymie : Etude toponymique des noms des montagne
Ouananich : Saumon d'eau douce péché au Canada
Oukase : Décision arbitraire, historiquement, édit promulgué par le tsar
Ovalie : Ensemble des régions du globe où l'on joue au rugby
Pacage : Terrain où vont paître les bestiaux
Pageot : Lit
Pairle : Meuble en forme d'Y dontl es branches atteignent les angles supérieurs de l'écu
Palestre : Dans l'antiquité, lieu public où l'on s'exercait à la lutte et à la gymnastique
Palisson : Instrument de fer qui sert à chamoiser
Palsambleu : Juron utilisé au XVII
Paltoquet : Homme insignifiant et prétentieux
Palustre : Qui se rapporte au marais
Pandiculation : Mouvement qui consiste à étendre les bras et les jambes tout en se penchant en arrière. Le fait de s'étirer
Panifiable : Qui peut servir comme matière première dans la fabrication du pain
Panspermie : Théorie selon laquelle la vie sur Terre est issue de germes venus d'ailleurs...
Parangon : Modèle
Paratexte : Ensemble formé par le péritexte et l'épitexte
Parémiologie : Etude des proverbes
Paronyme : Se dit de mots presque homonymes et qui peuvent facilement être confondus
Parturition : Accouchement
Pasquin : Bouffon
Patouillard : Navire lent, lourd et plutôt en mauvais état
Pattinsonage : Mode de traitement des plombs argentifères par cristallisation fractionnée, pour séparer l'argent du plomb
Pédieux : Qui a rapport ou appartient au pied
Péguer : Coller, enduire d'une substance visqueuse ou collante
Pellucide : Zone translucide
Pendeloque : Bijou suspendu à une boucle d'oreille
Péripatéticien : Partisan de la doctrine d'Aristote
Périssodactyles : Ordre de mammifères placentaires ongulés qui comprend des animaux reposant sur le sol par un nombre impair de doigts dont le médian est le plus développé
Périssologie : Pléonasme fautif (comme "descendre en bas")
Péronnelle : Jeune femme ou jeune fille sotte et bavarde
Petiole : Nom de la tige reliant la feuille au rameau
Pétrarquiser : Aimer platoniquement, comme Pétrarque aimait Laure
Pétulance : Ardeur exubérante, brusque et désordonnée
Pétuner : Fumer du tabac
Phatique : Fonction du langage utilisé pour établir une communication sans apport d'information ("allo", "bonjour"...)
Phénakistiscope : Appareil formé de deux disques qui donne l'illusion du mouvement par lapersistance des images rétiniennes
Photopériode : Répartition dans la journée entre la durée de la phase diurne et celle de la phase obscure
Phylarque : Président d'une tribu à Athènes
Phyllotaxie : Positionnement des feuilles d'arbres sur un rameau
Piaculaire : Relatif à une expiation
Piauler : Crier en pleurnichant
Pica : Goût morbide pour des substances non comestibles
Piétaille : Petit, subalterne
Pioupiou : Jeune fantassin
Placoter : Bavarder
Plurivoque : Qui a plusieurs valeurs
Pollicitation : Offre exprimée mais non encore acceptée
Porchaison : Saison pendant laquelle le sanglier est le plus gras
Satyriasis : Comportement de l'homme cherchant en permanence le plaisir sexuel. Equivalent à la nymphomanie chez la femme.
Sphinge : Sphinx à buste de femme
Succube : Démon féminin qui abuse d'un homme pendant son sommeil
Tautologie : Phrase toujours vraie, mais présentée de manière différente
Tétraktys : 10 points rangés en 4 rangés (1 puis 2, puis 3, puis 4) représentant un triangle, également appelé décade
Triskaidekaphobie : Phobie du nombre 13, et en particulier du Vendredi 13
Tuple : Enregistrement d'une base de données
Valetudinaire : Maladif, fébrile